.........
.RIB.....
...IO.OB.
.......P.
.G.GR....
YP.....MV
.VY......
.M.......
.........
