B......M.
.........
.........
M..R.P.B.
...G...I.
.O..YP...
.........
.OR..I...
..YG.....
