.......G.
.BY......
O........
P....RY..
..O.B...G
....IR..I
........P
.........
.........
